9 10
WWWWWWWWW
WbC0W00GW
W0W000WWW
WAWWWWW0W
W0000000W
W0WWWWWBW
W0WaW0W0W
W0W0W0W0W
WS0000WcW
WWWWWWWWW
